"filename", "language", "XML", "Java Properties", "Java", "PostCSS", "comment", "blank", "total"
"d:\Development\JAVA\Skripsi\Final 1.1\spk-topsis-new-format\build.xml", "XML", 4, 0, 0, 0, 49, 1, 54
"d:\Development\JAVA\Skripsi\Final 1.1\spk-topsis-new-format\build\built-jar.properties", "Java Properties", 0, 1, 0, 0, 1, 3, 5
"d:\Development\JAVA\Skripsi\Final 1.1\spk-topsis-new-format\build\classes\ac\id\unindra\spk\topsis\djingga\app\Main.class", "Java", 0, 0, 33, 0, 0, 0, 33
"d:\Development\JAVA\Skripsi\Final 1.1\spk-topsis-new-format\build\classes\ac\id\unindra\spk\topsis\djingga\controllers\OTPController.class", "Java", 0, 0, 66, 0, 0, 1, 67
"d:\Development\JAVA\Skripsi\Final 1.1\spk-topsis-new-format\build\classes\ac\id\unindra\spk\topsis\djingga\controllers\appController.class", "Java", 0, 0, 42, 0, 0, 0, 42
"d:\Development\JAVA\Skripsi\Final 1.1\spk-topsis-new-format\build\classes\ac\id\unindra\spk\topsis\djingga\controllers\forgotPasswordController.class", "Java", 0, 0, 50, 0, 0, 0, 50
"d:\Development\JAVA\Skripsi\Final 1.1\spk-topsis-new-format\build\classes\ac\id\unindra\spk\topsis\djingga\controllers\loginController.class", "Java", 0, 0, 35, 0, 0, 0, 35
"d:\Development\JAVA\Skripsi\Final 1.1\spk-topsis-new-format\build\classes\ac\id\unindra\spk\topsis\djingga\controllers\loginViewController$1.class", "Java", 0, 0, 20, 0, 0, 0, 20
"d:\Development\JAVA\Skripsi\Final 1.1\spk-topsis-new-format\build\classes\ac\id\unindra\spk\topsis\djingga\controllers\loginViewController.class", "Java", 0, 0, 163, 0, 0, 0, 163
"d:\Development\JAVA\Skripsi\Final 1.1\spk-topsis-new-format\build\classes\ac\id\unindra\spk\topsis\djingga\controllers\registerController.class", "Java", 0, 0, 33, 0, 0, 0, 33
"d:\Development\JAVA\Skripsi\Final 1.1\spk-topsis-new-format\build\classes\ac\id\unindra\spk\topsis\djingga\models\OTPModel.class", "Java", 0, 0, 13, 0, 0, 0, 13
"d:\Development\JAVA\Skripsi\Final 1.1\spk-topsis-new-format\build\classes\ac\id\unindra\spk\topsis\djingga\models\forgotPasswordModel.class", "Java", 0, 0, 11, 0, 0, 0, 11
"d:\Development\JAVA\Skripsi\Final 1.1\spk-topsis-new-format\build\classes\ac\id\unindra\spk\topsis\djingga\models\loginModel.class", "Java", 0, 0, 14, 0, 0, 0, 14
"d:\Development\JAVA\Skripsi\Final 1.1\spk-topsis-new-format\build\classes\ac\id\unindra\spk\topsis\djingga\models\registerModel.class", "Java", 0, 0, 16, 0, 0, 0, 16
"d:\Development\JAVA\Skripsi\Final 1.1\spk-topsis-new-format\build\classes\ac\id\unindra\spk\topsis\djingga\resources\css\login.css", "PostCSS", 0, 0, 0, 10, 0, 2, 12
"d:\Development\JAVA\Skripsi\Final 1.1\spk-topsis-new-format\build\classes\ac\id\unindra\spk\topsis\djingga\resources\css\styles.css", "PostCSS", 0, 0, 0, 22, 0, 3, 25
"d:\Development\JAVA\Skripsi\Final 1.1\spk-topsis-new-format\build\classes\ac\id\unindra\spk\topsis\djingga\services\OTPService.class", "Java", 0, 0, 5, 0, 0, 0, 5
"d:\Development\JAVA\Skripsi\Final 1.1\spk-topsis-new-format\build\classes\ac\id\unindra\spk\topsis\djingga\services\forgotPasswordService.class", "Java", 0, 0, 4, 0, 0, 1, 5
"d:\Development\JAVA\Skripsi\Final 1.1\spk-topsis-new-format\build\classes\ac\id\unindra\spk\topsis\djingga\services\loginService.class", "Java", 0, 0, 2, 0, 0, 0, 2
"d:\Development\JAVA\Skripsi\Final 1.1\spk-topsis-new-format\build\classes\ac\id\unindra\spk\topsis\djingga\services\registerService.class", "Java", 0, 0, 2, 0, 0, 1, 3
"d:\Development\JAVA\Skripsi\Final 1.1\spk-topsis-new-format\build\classes\ac\id\unindra\spk\topsis\djingga\utilities\CurrentDate.class", "Java", 0, 0, 14, 0, 0, 0, 14
"d:\Development\JAVA\Skripsi\Final 1.1\spk-topsis-new-format\build\classes\ac\id\unindra\spk\topsis\djingga\utilities\DatabaseConnection.class", "Java", 0, 0, 13, 0, 0, 0, 13
"d:\Development\JAVA\Skripsi\Final 1.1\spk-topsis-new-format\build\classes\ac\id\unindra\spk\topsis\djingga\utilities\EmailSender$1.class", "Java", 0, 0, 7, 0, 0, 0, 7
"d:\Development\JAVA\Skripsi\Final 1.1\spk-topsis-new-format\build\classes\ac\id\unindra\spk\topsis\djingga\utilities\EmailSender.class", "Java", 0, 0, 28, 0, 0, 0, 28
"d:\Development\JAVA\Skripsi\Final 1.1\spk-topsis-new-format\build\classes\ac\id\unindra\spk\topsis\djingga\utilities\NotificationManager.class", "Java", 0, 0, 15, 0, 0, 0, 15
"d:\Development\JAVA\Skripsi\Final 1.1\spk-topsis-new-format\build\classes\ac\id\unindra\spk\topsis\djingga\utilities\OTPGenerator.class", "Java", 0, 0, 25, 0, 0, 0, 25
"d:\Development\JAVA\Skripsi\Final 1.1\spk-topsis-new-format\build\classes\ac\id\unindra\spk\topsis\djingga\utilities\RandomTextGenerator.class", "Java", 0, 0, 21, 0, 0, 0, 21
"d:\Development\JAVA\Skripsi\Final 1.1\spk-topsis-new-format\build\classes\ac\id\unindra\spk\topsis\djingga\views\appView.fxml", "XML", 109, 0, 0, 0, 0, 3, 112
"d:\Development\JAVA\Skripsi\Final 1.1\spk-topsis-new-format\build\classes\ac\id\unindra\spk\topsis\djingga\views\loginView.fxml", "XML", 195, 0, 0, 0, 0, 3, 198
"d:\Development\JAVA\Skripsi\Final 1.1\spk-topsis-new-format\build\classes\ac\id\unindra\spk\topsis\djingga\views\userView.fxml", "XML", 286, 0, 0, 0, 0, 4, 290
"d:\Development\JAVA\Skripsi\Final 1.1\spk-topsis-new-format\lib\nblibraries.properties", "Java Properties", 0, 51, 0, 0, 0, 1, 52
"d:\Development\JAVA\Skripsi\Final 1.1\spk-topsis-new-format\nbproject\build-impl.xml", "XML", 1687, 0, 0, 0, 138, 1, 1826
"d:\Development\JAVA\Skripsi\Final 1.1\spk-topsis-new-format\nbproject\configs\Run_as_WebStart.properties", "Java Properties", 0, 1, 0, 0, 1, 1, 3
"d:\Development\JAVA\Skripsi\Final 1.1\spk-topsis-new-format\nbproject\configs\Run_in_Browser.properties", "Java Properties", 0, 1, 0, 0, 1, 1, 3
"d:\Development\JAVA\Skripsi\Final 1.1\spk-topsis-new-format\nbproject\genfiles.properties", "Java Properties", 0, 6, 0, 0, 2, 1, 9
"d:\Development\JAVA\Skripsi\Final 1.1\spk-topsis-new-format\nbproject\jfx-impl.xml", "XML", 3866, 0, 0, 0, 117, 215, 4198
"d:\Development\JAVA\Skripsi\Final 1.1\spk-topsis-new-format\nbproject\private\configs\Run_as_WebStart.properties", "Java Properties", 0, 1, 0, 0, 1, 1, 3
"d:\Development\JAVA\Skripsi\Final 1.1\spk-topsis-new-format\nbproject\private\configs\Run_in_Browser.properties", "Java Properties", 0, 1, 0, 0, 1, 1, 3
"d:\Development\JAVA\Skripsi\Final 1.1\spk-topsis-new-format\nbproject\private\private.properties", "Java Properties", 0, 13, 0, 0, 1, 1, 15
"d:\Development\JAVA\Skripsi\Final 1.1\spk-topsis-new-format\nbproject\private\private.xml", "XML", 7, 0, 0, 0, 0, 1, 8
"d:\Development\JAVA\Skripsi\Final 1.1\spk-topsis-new-format\nbproject\private\retriever\catalog.xml", "XML", 0, 0, 0, 0, 0, 1, 1
"d:\Development\JAVA\Skripsi\Final 1.1\spk-topsis-new-format\nbproject\project.properties", "Java Properties", 0, 124, 0, 0, 18, 1, 143
"d:\Development\JAVA\Skripsi\Final 1.1\spk-topsis-new-format\nbproject\project.xml", "XML", 29, 0, 0, 0, 0, 1, 30
"d:\Development\JAVA\Skripsi\Final 1.1\spk-topsis-new-format\src\ac\id\unindra\spk\topsis\djingga\DataAccessObject\AlternativeDAO.java", "Java", 0, 0, 196, 0, 0, 29, 225
"d:\Development\JAVA\Skripsi\Final 1.1\spk-topsis-new-format\src\ac\id\unindra\spk\topsis\djingga\DataAccessObject\CriteriaDAO.java", "Java", 0, 0, 285, 0, 1, 40, 326
"d:\Development\JAVA\Skripsi\Final 1.1\spk-topsis-new-format\src\ac\id\unindra\spk\topsis\djingga\DataAccessObject\ForgotPasswordDAO.java", "Java", 0, 0, 107, 0, 0, 15, 122
"d:\Development\JAVA\Skripsi\Final 1.1\spk-topsis-new-format\src\ac\id\unindra\spk\topsis\djingga\DataAccessObject\LoginDAO.java", "Java", 0, 0, 64, 0, 0, 13, 77
"d:\Development\JAVA\Skripsi\Final 1.1\spk-topsis-new-format\src\ac\id\unindra\spk\topsis\djingga\DataAccessObject\OtpDAO.java", "Java", 0, 0, 205, 0, 0, 30, 235
"d:\Development\JAVA\Skripsi\Final 1.1\spk-topsis-new-format\src\ac\id\unindra\spk\topsis\djingga\DataAccessObject\RegisterDAO.java", "Java", 0, 0, 91, 0, 0, 16, 107
"d:\Development\JAVA\Skripsi\Final 1.1\spk-topsis-new-format\src\ac\id\unindra\spk\topsis\djingga\DataAccessObject\SettingDAO.java", "Java", 0, 0, 75, 0, 0, 9, 84
"d:\Development\JAVA\Skripsi\Final 1.1\spk-topsis-new-format\src\ac\id\unindra\spk\topsis\djingga\DataAccessObject\TopsisDAO.java", "Java", 0, 0, 629, 0, 0, 99, 728
"d:\Development\JAVA\Skripsi\Final 1.1\spk-topsis-new-format\src\ac\id\unindra\spk\topsis\djingga\DataAccessObject\UserDAO.java", "Java", 0, 0, 160, 0, 0, 30, 190
"d:\Development\JAVA\Skripsi\Final 1.1\spk-topsis-new-format\src\ac\id\unindra\spk\topsis\djingga\app\Main.java", "Java", 0, 0, 30, 0, 0, 11, 41
"d:\Development\JAVA\Skripsi\Final 1.1\spk-topsis-new-format\src\ac\id\unindra\spk\topsis\djingga\app\Main__copy.java", "Java", 0, 0, 31, 0, 0, 11, 42
"d:\Development\JAVA\Skripsi\Final 1.1\spk-topsis-new-format\src\ac\id\unindra\spk\topsis\djingga\controllers\AddAlternativeViewController.java", "Java", 0, 0, 129, 0, 0, 24, 153
"d:\Development\JAVA\Skripsi\Final 1.1\spk-topsis-new-format\src\ac\id\unindra\spk\topsis\djingga\controllers\AddCriteriaViewContoller.java", "Java", 0, 0, 236, 0, 0, 45, 281
"d:\Development\JAVA\Skripsi\Final 1.1\spk-topsis-new-format\src\ac\id\unindra\spk\topsis\djingga\controllers\AlternativeViewController.java", "Java", 0, 0, 138, 0, 1, 35, 174
"d:\Development\JAVA\Skripsi\Final 1.1\spk-topsis-new-format\src\ac\id\unindra\spk\topsis\djingga\controllers\AppViewController.java", "Java", 0, 0, 270, 0, 0, 56, 326
"d:\Development\JAVA\Skripsi\Final 1.1\spk-topsis-new-format\src\ac\id\unindra\spk\topsis\djingga\controllers\CalcTopsisViewController.java", "Java", 0, 0, 482, 0, 2, 114, 598
"d:\Development\JAVA\Skripsi\Final 1.1\spk-topsis-new-format\src\ac\id\unindra\spk\topsis\djingga\controllers\CriteriaViewContoller.java", "Java", 0, 0, 139, 0, 1, 36, 176
"d:\Development\JAVA\Skripsi\Final 1.1\spk-topsis-new-format\src\ac\id\unindra\spk\topsis\djingga\controllers\DashboardViewController.java", "Java", 0, 0, 47, 0, 0, 15, 62
"d:\Development\JAVA\Skripsi\Final 1.1\spk-topsis-new-format\src\ac\id\unindra\spk\topsis\djingga\controllers\LoginViewController.java", "Java", 0, 0, 455, 0, 6, 76, 537
"d:\Development\JAVA\Skripsi\Final 1.1\spk-topsis-new-format\src\ac\id\unindra\spk\topsis\djingga\controllers\ResultTopsisViewController.java", "Java", 0, 0, 247, 0, 0, 45, 292
"d:\Development\JAVA\Skripsi\Final 1.1\spk-topsis-new-format\src\ac\id\unindra\spk\topsis\djingga\controllers\SettingViewController.java", "Java", 0, 0, 316, 0, 0, 86, 402
"d:\Development\JAVA\Skripsi\Final 1.1\spk-topsis-new-format\src\ac\id\unindra\spk\topsis\djingga\controllers\TopsisListController.java", "Java", 0, 0, 127, 0, 0, 26, 153
"d:\Development\JAVA\Skripsi\Final 1.1\spk-topsis-new-format\src\ac\id\unindra\spk\topsis\djingga\controllers\UserViewController.java", "Java", 0, 0, 210, 0, 0, 47, 257
"d:\Development\JAVA\Skripsi\Final 1.1\spk-topsis-new-format\src\ac\id\unindra\spk\topsis\djingga\models\AlternativeModel.java", "Java", 0, 0, 41, 0, 0, 16, 57
"d:\Development\JAVA\Skripsi\Final 1.1\spk-topsis-new-format\src\ac\id\unindra\spk\topsis\djingga\models\AlternativeTableModel.java", "Java", 0, 0, 21, 0, 0, 11, 32
"d:\Development\JAVA\Skripsi\Final 1.1\spk-topsis-new-format\src\ac\id\unindra\spk\topsis\djingga\models\CriteriaModel.java", "Java", 0, 0, 89, 0, 0, 35, 124
"d:\Development\JAVA\Skripsi\Final 1.1\spk-topsis-new-format\src\ac\id\unindra\spk\topsis\djingga\models\CriteriaTableModel.java", "Java", 0, 0, 35, 0, 0, 23, 58
"d:\Development\JAVA\Skripsi\Final 1.1\spk-topsis-new-format\src\ac\id\unindra\spk\topsis\djingga\models\ForgotPasswordModel.java", "Java", 0, 0, 34, 0, 0, 16, 50
"d:\Development\JAVA\Skripsi\Final 1.1\spk-topsis-new-format\src\ac\id\unindra\spk\topsis\djingga\models\LoginModel.java", "Java", 0, 0, 52, 0, 0, 19, 71
"d:\Development\JAVA\Skripsi\Final 1.1\spk-topsis-new-format\src\ac\id\unindra\spk\topsis\djingga\models\OTPModel.java", "Java", 0, 0, 28, 0, 0, 12, 40
"d:\Development\JAVA\Skripsi\Final 1.1\spk-topsis-new-format\src\ac\id\unindra\spk\topsis\djingga\models\RegisterModel.java", "Java", 0, 0, 58, 0, 0, 21, 79
"d:\Development\JAVA\Skripsi\Final 1.1\spk-topsis-new-format\src\ac\id\unindra\spk\topsis\djingga\models\SettingModel.java", "Java", 0, 0, 22, 0, 0, 8, 30
"d:\Development\JAVA\Skripsi\Final 1.1\spk-topsis-new-format\src\ac\id\unindra\spk\topsis\djingga\models\TopsisModel.java", "Java", 0, 0, 139, 0, 0, 49, 188
"d:\Development\JAVA\Skripsi\Final 1.1\spk-topsis-new-format\src\ac\id\unindra\spk\topsis\djingga\models\TopsisTableListModel.java", "Java", 0, 0, 35, 0, 0, 14, 49
"d:\Development\JAVA\Skripsi\Final 1.1\spk-topsis-new-format\src\ac\id\unindra\spk\topsis\djingga\models\TopsisTableRankModel.java", "Java", 0, 0, 28, 0, 0, 14, 42
"d:\Development\JAVA\Skripsi\Final 1.1\spk-topsis-new-format\src\ac\id\unindra\spk\topsis\djingga\models\UserModel.java", "Java", 0, 0, 77, 0, 0, 6, 83
"d:\Development\JAVA\Skripsi\Final 1.1\spk-topsis-new-format\src\ac\id\unindra\spk\topsis\djingga\models\UserTableModel.java", "Java", 0, 0, 42, 0, 0, 10, 52
"d:\Development\JAVA\Skripsi\Final 1.1\spk-topsis-new-format\src\ac\id\unindra\spk\topsis\djingga\resources\css\styles.css", "PostCSS", 0, 0, 0, 118, 6, 29, 153
"d:\Development\JAVA\Skripsi\Final 1.1\spk-topsis-new-format\src\ac\id\unindra\spk\topsis\djingga\services\AlternativeService.java", "Java", 0, 0, 13, 0, 0, 3, 16
"d:\Development\JAVA\Skripsi\Final 1.1\spk-topsis-new-format\src\ac\id\unindra\spk\topsis\djingga\services\CriteriaService.java", "Java", 0, 0, 13, 0, 0, 2, 15
"d:\Development\JAVA\Skripsi\Final 1.1\spk-topsis-new-format\src\ac\id\unindra\spk\topsis\djingga\services\ForgotPasswordService.java", "Java", 0, 0, 8, 0, 0, 4, 12
"d:\Development\JAVA\Skripsi\Final 1.1\spk-topsis-new-format\src\ac\id\unindra\spk\topsis\djingga\services\LoginService.java", "Java", 0, 0, 5, 0, 0, 3, 8
"d:\Development\JAVA\Skripsi\Final 1.1\spk-topsis-new-format\src\ac\id\unindra\spk\topsis\djingga\services\OTPService.java", "Java", 0, 0, 12, 0, 0, 5, 17
"d:\Development\JAVA\Skripsi\Final 1.1\spk-topsis-new-format\src\ac\id\unindra\spk\topsis\djingga\services\RegisterService.java", "Java", 0, 0, 7, 0, 0, 3, 10
"d:\Development\JAVA\Skripsi\Final 1.1\spk-topsis-new-format\src\ac\id\unindra\spk\topsis\djingga\services\SettingService.java", "Java", 0, 0, 8, 0, 0, 3, 11
"d:\Development\JAVA\Skripsi\Final 1.1\spk-topsis-new-format\src\ac\id\unindra\spk\topsis\djingga\services\TopsisService.java", "Java", 0, 0, 31, 0, 0, 16, 47
"d:\Development\JAVA\Skripsi\Final 1.1\spk-topsis-new-format\src\ac\id\unindra\spk\topsis\djingga\services\UserService.java", "Java", 0, 0, 11, 0, 0, 4, 15
"d:\Development\JAVA\Skripsi\Final 1.1\spk-topsis-new-format\src\ac\id\unindra\spk\topsis\djingga\utilities\CurrentDate.java", "Java", 0, 0, 17, 0, 0, 5, 22
"d:\Development\JAVA\Skripsi\Final 1.1\spk-topsis-new-format\src\ac\id\unindra\spk\topsis\djingga\utilities\DatabaseConnection.java", "Java", 0, 0, 29, 0, 0, 7, 36
"d:\Development\JAVA\Skripsi\Final 1.1\spk-topsis-new-format\src\ac\id\unindra\spk\topsis\djingga\utilities\EmailSender.java", "Java", 0, 0, 32, 0, 0, 7, 39
"d:\Development\JAVA\Skripsi\Final 1.1\spk-topsis-new-format\src\ac\id\unindra\spk\topsis\djingga\utilities\NotificationManager.java", "Java", 0, 0, 14, 0, 0, 3, 17
"d:\Development\JAVA\Skripsi\Final 1.1\spk-topsis-new-format\src\ac\id\unindra\spk\topsis\djingga\utilities\OTPGenerator.java", "Java", 0, 0, 18, 0, 3, 8, 29
"d:\Development\JAVA\Skripsi\Final 1.1\spk-topsis-new-format\src\ac\id\unindra\spk\topsis\djingga\utilities\RandomTextGenerator.java", "Java", 0, 0, 18, 0, 0, 8, 26
"d:\Development\JAVA\Skripsi\Final 1.1\spk-topsis-new-format\src\ac\id\unindra\spk\topsis\djingga\views\AddAlternativeView.fxml", "XML", 41, 0, 0, 0, 0, 3, 44
"d:\Development\JAVA\Skripsi\Final 1.1\spk-topsis-new-format\src\ac\id\unindra\spk\topsis\djingga\views\AddCriteriaView.fxml", "XML", 98, 0, 0, 0, 0, 3, 101
"d:\Development\JAVA\Skripsi\Final 1.1\spk-topsis-new-format\src\ac\id\unindra\spk\topsis\djingga\views\AlternativeView.fxml", "XML", 105, 0, 0, 0, 0, 3, 108
"d:\Development\JAVA\Skripsi\Final 1.1\spk-topsis-new-format\src\ac\id\unindra\spk\topsis\djingga\views\AppView.fxml", "XML", 209, 0, 0, 0, 0, 3, 212
"d:\Development\JAVA\Skripsi\Final 1.1\spk-topsis-new-format\src\ac\id\unindra\spk\topsis\djingga\views\CalcTopsisView.fxml", "XML", 168, 0, 0, 0, 0, 3, 171
"d:\Development\JAVA\Skripsi\Final 1.1\spk-topsis-new-format\src\ac\id\unindra\spk\topsis\djingga\views\CriteriaView.fxml", "XML", 165, 0, 0, 0, 0, 3, 168
"d:\Development\JAVA\Skripsi\Final 1.1\spk-topsis-new-format\src\ac\id\unindra\spk\topsis\djingga\views\DashboardView.fxml", "XML", 135, 0, 0, 0, 0, 3, 138
"d:\Development\JAVA\Skripsi\Final 1.1\spk-topsis-new-format\src\ac\id\unindra\spk\topsis\djingga\views\LoginView.fxml", "XML", 195, 0, 0, 0, 0, 3, 198
"d:\Development\JAVA\Skripsi\Final 1.1\spk-topsis-new-format\src\ac\id\unindra\spk\topsis\djingga\views\SettingView.fxml", "XML", 164, 0, 0, 0, 0, 3, 167
"d:\Development\JAVA\Skripsi\Final 1.1\spk-topsis-new-format\src\ac\id\unindra\spk\topsis\djingga\views\TopsisListView.fxml", "XML", 92, 0, 0, 0, 0, 3, 95
"d:\Development\JAVA\Skripsi\Final 1.1\spk-topsis-new-format\src\ac\id\unindra\spk\topsis\djingga\views\TopsisResultView.fxml", "XML", 304, 0, 0, 0, 0, 3, 307
"d:\Development\JAVA\Skripsi\Final 1.1\spk-topsis-new-format\src\ac\id\unindra\spk\topsis\djingga\views\UserView.fxml", "XML", 230, 0, 0, 0, 0, 3, 233
"Total", "-", 8089, 199, 6238, 150, 350, 1557, 16583